68 148
114 68 148
108 153
40 242
106 132
134 281
93 108 153
77 139
26 134 281
204 106 132
194 93 108 153
224 26 134 281
194 93 108 153 224 26 134 281
204 106 132 194 93 108 153 224 26 134 281
214 204 106 132 194 93 108 153 224 26 134 281
159 214 204 106 132 194 93 108 153 224 26 134 281
40 242 159 214 204 106 132 194 93 108 153 224 26 134 281
33 149
112 33 149
288 40 242 159 214 204 106 132 194 93 108 153 224 26 134 281
143 114 68 148
77 139 143 114 68 148
112 33 149 288 40 242 159 214 204 106 132 194 93 108 153 224 26 134 281
107 77 139 143 114 68 148
112 33 149 288 40 242 159 214 204 106 132 194 93 108 153 224 26 134 281 107 77 139 143 114 68 148