132 134
214 224
204 214 224
194 204 214 224
132 134 194 204 214 224
26 132 134 194 204 214 224
68 114
108 153
148 68 114
40 242
281 26 132 134 194 204 214 224
77 139
159 108 153
106 281 26 132 134 194 204 214 224
93 159 108 153
106 281 26 132 134 194 204 214 224 93 159 108 153
149 148 68 114
40 242 106 281 26 132 134 194 204 214 224 93 159 108 153
33 112
143 77 139
288 40 242 106 281 26 132 134 194 204 214 224 93 159 108 153
149 148 68 114 288 40 242 106 281 26 132 134 194 204 214 224 93 159 108 153
33 112 143 77 139
107 33 112 143 77 139
149 148 68 114 288 40 242 106 281 26 132 134 194 204 214 224 93 159 108 153 107 33 112 143 77 139