149 169
68 148
114 68 148
184 149 169
93 102
153 285
241 290
155 182
88 181
70 81
86 232
128 176
20 173
26 136
51 110
58 289
75 70 81
10 116
65 20 173
84 100
13 242
79 99
16 243
170 93 102
19 46
4 14
90 134
163 153 285
88 181 128 176
82 132
39 91
80 26 136
154 164
61 135
40 63
38 75 70 81
129 13 242
52 296
105 80 26 136
261 61 135
56 106
209 86 232
27 16 243
3 201
133 280
214 279
65 20 173 19 46
208 265
104 82 132
117 170 93 102
203 84 100
108 163 153 285
241 290 155 182
211 79 99
105 80 26 136 261 61 135
67 88 181 128 176
115 129 13 242
8 92
238 105 80 26 136 261 61 135
179 224
221 67 88 181 128 176
108 163 153 285 241 290 155 182
3 201 238 105 80 26 136 261 61 135
137 210
217 225
38 75 70 81 214 279
239 117 170 93 102
40 63 115 129 13 242
240 154 164
35 221 67 88 181 128 176
209 86 232 133 280
3 201 238 105 80 26 136 261 61 135 38 75 70 81 214 279
56 106 35 221 67 88 181 128 176
283 58 289
208 265 104 82 132
12 165
17 54
126 39 91
215 271
197 281
78 90 134
194 274
213 270
196 276
211 79 99 56 106 35 221 67 88 181 128 176
216 65 20 173 19 46
205 263
206 277
3 201 238 105 80 26 136 261 61 135 38 75 70 81 214 279 211 79 99 56 106 35 221 67 88 181 128 176
292 51 110
62 27 16 243
209 86 232 133 280 3 201 238 105 80 26 136 261 61 135 38 75 70 81 214 279 211 79 99 56 106 35 221 67 88 181 128 176
108 163 153 285 241 290 155 182 239 117 170 93 102
245 203 84 100
208 265 104 82 132 209 86 232 133 280 3 201 238 105 80 26 136 261 61 135 38 75 70 81 214 279 211 79 99 56 106 35 221 67 88 181 128 176
217 225 78 90 134
179 224 126 39 91
240 154 164 108 163 153 285 241 290 155 182 239 117 170 93 102
245 203 84 100 208 265 104 82 132 209 86 232 133 280 3 201 238 105 80 26 136 261 61 135 38 75 70 81 214 279 211 79 99 56 106 35 221 67 88 181 128 176
137 210 245 203 84 100 208 265 104 82 132 209 86 232 133 280 3 201 238 105 80 26 136 261 61 135 38 75 70 81 214 279 211 79 99 56 106 35 221 67 88 181 128 176
77 139
52 296 40 63 115 129 13 242
283 58 289 292 51 110
217 225 78 90 134 137 210 245 203 84 100 208 265 104 82 132 209 86 232 133 280 3 201 238 105 80 26 136 261 61 135 38 75 70 81 214 279 211 79 99 56 106 35 221 67 88 181 128 176
179 224 126 39 91 217 225 78 90 134 137 210 245 203 84 100 208 265 104 82 132 209 86 232 133 280 3 201 238 105 80 26 136 261 61 135 38 75 70 81 214 279 211 79 99 56 106 35 221 67 88 181 128 176
216 65 20 173 19 46 179 224 126 39 91 217 225 78 90 134 137 210 245 203 84 100 208 265 104 82 132 209 86 232 133 280 3 201 238 105 80 26 136 261 61 135 38 75 70 81 214 279 211 79 99 56 106 35 221 67 88 181 128 176
219 246
195 228
62 27 16 243 52 296 40 63 115 129 13 242
205 263 216 65 20 173 19 46 179 224 126 39 91 217 225 78 90 134 137 210 245 203 84 100 208 265 104 82 132 209 86 232 133 280 3 201 238 105 80 26 136 261 61 135 38 75 70 81 214 279 211 79 99 56 106 35 221 67 88 181 128 176
183 240 154 164 108 163 153 285 241 290 155 182 239 117 170 93 102
199 205 263 216 65 20 173 19 46 179 224 126 39 91 217 225 78 90 134 137 210 245 203 84 100 208 265 104 82 132 209 86 232 133 280 3 201 238 105 80 26 136 261 61 135 38 75 70 81 214 279 211 79 99 56 106 35 221 67 88 181 128 176
219 246 199 205 263 216 65 20 173 19 46 179 224 126 39 91 217 225 78 90 134 137 210 245 203 84 100 208 265 104 82 132 209 86 232 133 280 3 201 238 105 80 26 136 261 61 135 38 75 70 81 214 279 211 79 99 56 106 35 221 67 88 181 128 176
212 183 240 154 164 108 163 153 285 241 290 155 182 239 117 170 93 102
196 276 219 246 199 205 263 216 65 20 173 19 46 179 224 126 39 91 217 225 78 90 134 137 210 245 203 84 100 208 265 104 82 132 209 86 232 133 280 3 201 238 105 80 26 136 261 61 135 38 75 70 81 214 279 211 79 99 56 106 35 221 67 88 181 128 176
206 277 196 276 219 246 199 205 263 216 65 20 173 19 46 179 224 126 39 91 217 225 78 90 134 137 210 245 203 84 100 208 265 104 82 132 209 86 232 133 280 3 201 238 105 80 26 136 261 61 135 38 75 70 81 214 279 211 79 99 56 106 35 221 67 88 181 128 176
249 253
215 271 206 277 196 276 219 246 199 205 263 216 65 20 173 19 46 179 224 126 39 91 217 225 78 90 134 137 210 245 203 84 100 208 265 104 82 132 209 86 232 133 280 3 201 238 105 80 26 136 261 61 135 38 75 70 81 214 279 211 79 99 56 106 35 221 67 88 181 128 176
220 212 183 240 154 164 108 163 153 285 241 290 155 182 239 117 170 93 102
194 274 215 271 206 277 196 276 219 246 199 205 263 216 65 20 173 19 46 179 224 126 39 91 217 225 78 90 134 137 210 245 203 84 100 208 265 104 82 132 209 86 232 133 280 3 201 238 105 80 26 136 261 61 135 38 75 70 81 214 279 211 79 99 56 106 35 221 67 88 181 128 176
55 12 165
66 197 281
220 212 183 240 154 164 108 163 153 285 241 290 155 182 239 117 170 93 102 194 274 215 271 206 277 196 276 219 246 199 205 263 216 65 20 173 19 46 179 224 126 39 91 217 225 78 90 134 137 210 245 203 84 100 208 265 104 82 132 209 86 232 133 280 3 201 238 105 80 26 136 261 61 135 38 75 70 81 214 279 211 79 99 56 106 35 221 67 88 181 128 176
247 184 149 169
10 116 62 27 16 243 52 296 40 63 115 129 13 242
213 270 220 212 183 240 154 164 108 163 153 285 241 290 155 182 239 117 170 93 102 194 274 215 271 206 277 196 276 219 246 199 205 263 216 65 20 173 19 46 179 224 126 39 91 217 225 78 90 134 137 210 245 203 84 100 208 265 104 82 132 209 86 232 133 280 3 201 238 105 80 26 136 261 61 135 38 75 70 81 214 279 211 79 99 56 106 35 221 67 88 181 128 176
223 283 58 289 292 51 110
66 197 281 213 270 220 212 183 240 154 164 108 163 153 285 241 290 155 182 239 117 170 93 102 194 274 215 271 206 277 196 276 219 246 199 205 263 216 65 20 173 19 46 179 224 126 39 91 217 225 78 90 134 137 210 245 203 84 100 208 265 104 82 132 209 86 232 133 280 3 201 238 105 80 26 136 261 61 135 38 75 70 81 214 279 211 79 99 56 106 35 221 67 88 181 128 176
195 228 66 197 281 213 270 220 212 183 240 154 164 108 163 153 285 241 290 155 182 239 117 170 93 102 194 274 215 271 206 277 196 276 219 246 199 205 263 216 65 20 173 19 46 179 224 126 39 91 217 225 78 90 134 137 210 245 203 84 100 208 265 104 82 132 209 86 232 133 280 3 201 238 105 80 26 136 261 61 135 38 75 70 81 214 279 211 79 99 56 106 35 221 67 88 181 128 176
222 195 228 66 197 281 213 270 220 212 183 240 154 164 108 163 153 285 241 290 155 182 239 117 170 93 102 194 274 215 271 206 277 196 276 219 246 199 205 263 216 65 20 173 19 46 179 224 126 39 91 217 225 78 90 134 137 210 245 203 84 100 208 265 104 82 132 209 86 232 133 280 3 201 238 105 80 26 136 261 61 135 38 75 70 81 214 279 211 79 99 56 106 35 221 67 88 181 128 176
204 222 195 228 66 197 281 213 270 220 212 183 240 154 164 108 163 153 285 241 290 155 182 239 117 170 93 102 194 274 215 271 206 277 196 276 219 246 199 205 263 216 65 20 173 19 46 179 224 126 39 91 217 225 78 90 134 137 210 245 203 84 100 208 265 104 82 132 209 86 232 133 280 3 201 238 105 80 26 136 261 61 135 38 75 70 81 214 279 211 79 99 56 106 35 221 67 88 181 128 176
218 244
202 204 222 195 228 66 197 281 213 270 220 212 183 240 154 164 108 163 153 285 241 290 155 182 239 117 170 93 102 194 274 215 271 206 277 196 276 219 246 199 205 263 216 65 20 173 19 46 179 224 126 39 91 217 225 78 90 134 137 210 245 203 84 100 208 265 104 82 132 209 86 232 133 280 3 201 238 105 80 26 136 261 61 135 38 75 70 81 214 279 211 79 99 56 106 35 221 67 88 181 128 176
223 283 58 289 292 51 110 202 204 222 195 228 66 197 281 213 270 220 212 183 240 154 164 108 163 153 285 241 290 155 182 239 117 170 93 102 194 274 215 271 206 277 196 276 219 246 199 205 263 216 65 20 173 19 46 179 224 126 39 91 217 225 78 90 134 137 210 245 203 84 100 208 265 104 82 132 209 86 232 133 280 3 201 238 105 80 26 136 261 61 135 38 75 70 81 214 279 211 79 99 56 106 35 221 67 88 181 128 176
4 14 10 116 62 27 16 243 52 296 40 63 115 129 13 242
288 8 92
248 249 253
198 223 283 58 289 292 51 110 202 204 222 195 228 66 197 281 213 270 220 212 183 240 154 164 108 163 153 285 241 290 155 182 239 117 170 93 102 194 274 215 271 206 277 196 276 219 246 199 205 263 216 65 20 173 19 46 179 224 126 39 91 217 225 78 90 134 137 210 245 203 84 100 208 265 104 82 132 209 86 232 133 280 3 201 238 105 80 26 136 261 61 135 38 75 70 81 214 279 211 79 99 56 106 35 221 67 88 181 128 176
218 244 198 223 283 58 289 292 51 110 202 204 222 195 228 66 197 281 213 270 220 212 183 240 154 164 108 163 153 285 241 290 155 182 239 117 170 93 102 194 274 215 271 206 277 196 276 219 246 199 205 263 216 65 20 173 19 46 179 224 126 39 91 217 225 78 90 134 137 210 245 203 84 100 208 265 104 82 132 209 86 232 133 280 3 201 238 105 80 26 136 261 61 135 38 75 70 81 214 279 211 79 99 56 106 35 221 67 88 181 128 176
55 12 165 4 14 10 116 62 27 16 243 52 296 40 63 115 129 13 242
142 77 139
17 54 55 12 165 4 14 10 116 62 27 16 243 52 296 40 63 115 129 13 242
230 17 54 55 12 165 4 14 10 116 62 27 16 243 52 296 40 63 115 129 13 242
254 248 249 253
229 230 17 54 55 12 165 4 14 10 116 62 27 16 243 52 296 40 63 115 129 13 242
159 250
251 254 248 249 253
53 229 230 17 54 55 12 165 4 14 10 116 62 27 16 243 52 296 40 63 115 129 13 242
231 53 229 230 17 54 55 12 165 4 14 10 116 62 27 16 243 52 296 40 63 115 129 13 242
159 250 251 254 248 249 253
218 244 198 223 283 58 289 292 51 110 202 204 222 195 228 66 197 281 213 270 220 212 183 240 154 164 108 163 153 285 241 290 155 182 239 117 170 93 102 194 274 215 271 206 277 196 276 219 246 199 205 263 216 65 20 173 19 46 179 224 126 39 91 217 225 78 90 134 137 210 245 203 84 100 208 265 104 82 132 209 86 232 133 280 3 201 238 105 80 26 136 261 61 135 38 75 70 81 214 279 211 79 99 56 106 35 221 67 88 181 128 176 159 250 251 254 248 249 253
299 218 244 198 223 283 58 289 292 51 110 202 204 222 195 228 66 197 281 213 270 220 212 183 240 154 164 108 163 153 285 241 290 155 182 239 117 170 93 102 194 274 215 271 206 277 196 276 219 246 199 205 263 216 65 20 173 19 46 179 224 126 39 91 217 225 78 90 134 137 210 245 203 84 100 208 265 104 82 132 209 86 232 133 280 3 201 238 105 80 26 136 261 61 135 38 75 70 81 214 279 211 79 99 56 106 35 221 67 88 181 128 176 159 250 251 254 248 249 253
255 299 218 244 198 223 283 58 289 292 51 110 202 204 222 195 228 66 197 281 213 270 220 212 183 240 154 164 108 163 153 285 241 290 155 182 239 117 170 93 102 194 274 215 271 206 277 196 276 219 246 199 205 263 216 65 20 173 19 46 179 224 126 39 91 217 225 78 90 134 137 210 245 203 84 100 208 265 104 82 132 209 86 232 133 280 3 201 238 105 80 26 136 261 61 135 38 75 70 81 214 279 211 79 99 56 106 35 221 67 88 181 128 176 159 250 251 254 248 249 253
144 255 299 218 244 198 223 283 58 289 292 51 110 202 204 222 195 228 66 197 281 213 270 220 212 183 240 154 164 108 163 153 285 241 290 155 182 239 117 170 93 102 194 274 215 271 206 277 196 276 219 246 199 205 263 216 65 20 173 19 46 179 224 126 39 91 217 225 78 90 134 137 210 245 203 84 100 208 265 104 82 132 209 86 232 133 280 3 201 238 105 80 26 136 261 61 135 38 75 70 81 214 279 211 79 99 56 106 35 221 67 88 181 128 176 159 250 251 254 248 249 253
21 112
231 53 229 230 17 54 55 12 165 4 14 10 116 62 27 16 243 52 296 40 63 115 129 13 242 144 255 299 218 244 198 223 283 58 289 292 51 110 202 204 222 195 228 66 197 281 213 270 220 212 183 240 154 164 108 163 153 285 241 290 155 182 239 117 170 93 102 194 274 215 271 206 277 196 276 219 246 199 205 263 216 65 20 173 19 46 179 224 126 39 91 217 225 78 90 134 137 210 245 203 84 100 208 265 104 82 132 209 86 232 133 280 3 201 238 105 80 26 136 261 61 135 38 75 70 81 214 279 211 79 99 56 106 35 221 67 88 181 128 176 159 250 251 254 248 249 253
190 191
33 21 112
32 247 184 149 169
2 114 68 148
33 21 112 32 247 184 149 169
231 53 229 230 17 54 55 12 165 4 14 10 116 62 27 16 243 52 296 40 63 115 129 13 242 144 255 299 218 244 198 223 283 58 289 292 51 110 202 204 222 195 228 66 197 281 213 270 220 212 183 240 154 164 108 163 153 285 241 290 155 182 239 117 170 93 102 194 274 215 271 206 277 196 276 219 246 199 205 263 216 65 20 173 19 46 179 224 126 39 91 217 225 78 90 134 137 210 245 203 84 100 208 265 104 82 132 209 86 232 133 280 3 201 238 105 80 26 136 261 61 135 38 75 70 81 214 279 211 79 99 56 106 35 221 67 88 181 128 176 159 250 251 254 248 249 253 190 191
143 142 77 139
123 231 53 229 230 17 54 55 12 165 4 14 10 116 62 27 16 243 52 296 40 63 115 129 13 242 144 255 299 218 244 198 223 283 58 289 292 51 110 202 204 222 195 228 66 197 281 213 270 220 212 183 240 154 164 108 163 153 285 241 290 155 182 239 117 170 93 102 194 274 215 271 206 277 196 276 219 246 199 205 263 216 65 20 173 19 46 179 224 126 39 91 217 225 78 90 134 137 210 245 203 84 100 208 265 104 82 132 209 86 232 133 280 3 201 238 105 80 26 136 261 61 135 38 75 70 81 214 279 211 79 99 56 106 35 221 67 88 181 128 176 159 250 251 254 248 249 253 190 191
288 8 92 123 231 53 229 230 17 54 55 12 165 4 14 10 116 62 27 16 243 52 296 40 63 115 129 13 242 144 255 299 218 244 198 223 283 58 289 292 51 110 202 204 222 195 228 66 197 281 213 270 220 212 183 240 154 164 108 163 153 285 241 290 155 182 239 117 170 93 102 194 274 215 271 206 277 196 276 219 246 199 205 263 216 65 20 173 19 46 179 224 126 39 91 217 225 78 90 134 137 210 245 203 84 100 208 265 104 82 132 209 86 232 133 280 3 201 238 105 80 26 136 261 61 135 38 75 70 81 214 279 211 79 99 56 106 35 221 67 88 181 128 176 159 250 251 254 248 249 253 190 191
186 288 8 92 123 231 53 229 230 17 54 55 12 165 4 14 10 116 62 27 16 243 52 296 40 63 115 129 13 242 144 255 299 218 244 198 223 283 58 289 292 51 110 202 204 222 195 228 66 197 281 213 270 220 212 183 240 154 164 108 163 153 285 241 290 155 182 239 117 170 93 102 194 274 215 271 206 277 196 276 219 246 199 205 263 216 65 20 173 19 46 179 224 126 39 91 217 225 78 90 134 137 210 245 203 84 100 208 265 104 82 132 209 86 232 133 280 3 201 238 105 80 26 136 261 61 135 38 75 70 81 214 279 211 79 99 56 106 35 221 67 88 181 128 176 159 250 251 254 248 249 253 190 191
107 2 114 68 148
143 142 77 139 107 2 114 68 148
33 21 112 32 247 184 149 169 186 288 8 92 123 231 53 229 230 17 54 55 12 165 4 14 10 116 62 27 16 243 52 296 40 63 115 129 13 242 144 255 299 218 244 198 223 283 58 289 292 51 110 202 204 222 195 228 66 197 281 213 270 220 212 183 240 154 164 108 163 153 285 241 290 155 182 239 117 170 93 102 194 274 215 271 206 277 196 276 219 246 199 205 263 216 65 20 173 19 46 179 224 126 39 91 217 225 78 90 134 137 210 245 203 84 100 208 265 104 82 132 209 86 232 133 280 3 201 238 105 80 26 136 261 61 135 38 75 70 81 214 279 211 79 99 56 106 35 221 67 88 181 128 176 159 250 251 254 248 249 253 190 191
145 33 21 112 32 247 184 149 169 186 288 8 92 123 231 53 229 230 17 54 55 12 165 4 14 10 116 62 27 16 243 52 296 40 63 115 129 13 242 144 255 299 218 244 198 223 283 58 289 292 51 110 202 204 222 195 228 66 197 281 213 270 220 212 183 240 154 164 108 163 153 285 241 290 155 182 239 117 170 93 102 194 274 215 271 206 277 196 276 219 246 199 205 263 216 65 20 173 19 46 179 224 126 39 91 217 225 78 90 134 137 210 245 203 84 100 208 265 104 82 132 209 86 232 133 280 3 201 238 105 80 26 136 261 61 135 38 75 70 81 214 279 211 79 99 56 106 35 221 67 88 181 128 176 159 250 251 254 248 249 253 190 191
30 37
57 145 33 21 112 32 247 184 149 169 186 288 8 92 123 231 53 229 230 17 54 55 12 165 4 14 10 116 62 27 16 243 52 296 40 63 115 129 13 242 144 255 299 218 244 198 223 283 58 289 292 51 110 202 204 222 195 228 66 197 281 213 270 220 212 183 240 154 164 108 163 153 285 241 290 155 182 239 117 170 93 102 194 274 215 271 206 277 196 276 219 246 199 205 263 216 65 20 173 19 46 179 224 126 39 91 217 225 78 90 134 137 210 245 203 84 100 208 265 104 82 132 209 86 232 133 280 3 201 238 105 80 26 136 261 61 135 38 75 70 81 214 279 211 79 99 56 106 35 221 67 88 181 128 176 159 250 251 254 248 249 253 190 191
258 57 145 33 21 112 32 247 184 149 169 186 288 8 92 123 231 53 229 230 17 54 55 12 165 4 14 10 116 62 27 16 243 52 296 40 63 115 129 13 242 144 255 299 218 244 198 223 283 58 289 292 51 110 202 204 222 195 228 66 197 281 213 270 220 212 183 240 154 164 108 163 153 285 241 290 155 182 239 117 170 93 102 194 274 215 271 206 277 196 276 219 246 199 205 263 216 65 20 173 19 46 179 224 126 39 91 217 225 78 90 134 137 210 245 203 84 100 208 265 104 82 132 209 86 232 133 280 3 201 238 105 80 26 136 261 61 135 38 75 70 81 214 279 211 79 99 56 106 35 221 67 88 181 128 176 159 250 251 254 248 249 253 190 191
259 298
143 142 77 139 107 2 114 68 148 259 298
30 37 258 57 145 33 21 112 32 247 184 149 169 186 288 8 92 123 231 53 229 230 17 54 55 12 165 4 14 10 116 62 27 16 243 52 296 40 63 115 129 13 242 144 255 299 218 244 198 223 283 58 289 292 51 110 202 204 222 195 228 66 197 281 213 270 220 212 183 240 154 164 108 163 153 285 241 290 155 182 239 117 170 93 102 194 274 215 271 206 277 196 276 219 246 199 205 263 216 65 20 173 19 46 179 224 126 39 91 217 225 78 90 134 137 210 245 203 84 100 208 265 104 82 132 209 86 232 133 280 3 201 238 105 80 26 136 261 61 135 38 75 70 81 214 279 211 79 99 56 106 35 221 67 88 181 128 176 159 250 251 254 248 249 253 190 191
143 142 77 139 107 2 114 68 148 259 298 30 37 258 57 145 33 21 112 32 247 184 149 169 186 288 8 92 123 231 53 229 230 17 54 55 12 165 4 14 10 116 62 27 16 243 52 296 40 63 115 129 13 242 144 255 299 218 244 198 223 283 58 289 292 51 110 202 204 222 195 228 66 197 281 213 270 220 212 183 240 154 164 108 163 153 285 241 290 155 182 239 117 170 93 102 194 274 215 271 206 277 196 276 219 246 199 205 263 216 65 20 173 19 46 179 224 126 39 91 217 225 78 90 134 137 210 245 203 84 100 208 265 104 82 132 209 86 232 133 280 3 201 238 105 80 26 136 261 61 135 38 75 70 81 214 279 211 79 99 56 106 35 221 67 88 181 128 176 159 250 251 254 248 249 253 190 191