270 281
274 270 281
210 215
271 274 270 281
196 212
194 196 212
38 39
197 210 215
206 194 196 212
132 134
135 132 134
218 206 194 196 212
202 222
195 203
204 217
220 204 217
221 202 222
38 39 135 132 134
224 195 203
198 224 195 203
201 213
216 201 213
104 105
223 198 224 195 203
197 210 215 221 202 222
209 214
218 206 194 196 212 197 210 215 221 202 222
220 204 217 223 198 224 195 203
263 277
216 201 213 220 204 217 223 198 224 195 203
211 219
209 214 216 201 213 220 204 217 223 198 224 195 203
208 211 219
265 279
218 206 194 196 212 197 210 215 221 202 222 208 211 219
209 214 216 201 213 220 204 217 223 198 224 195 203 218 206 194 196 212 197 210 215 221 202 222 208 211 219
133 38 39 135 132 134
271 274 270 281 263 277
199 209 214 216 201 213 220 204 217 223 198 224 195 203 218 206 194 196 212 197 210 215 221 202 222 208 211 219
261 280
82 84
79 82 84
205 199 209 214 216 201 213 220 204 217 223 198 224 195 203 218 206 194 196 212 197 210 215 221 202 222 208 211 219
88 90
79 82 84 88 90
86 79 82 84 88 90
81 86 79 82 84 88 90
265 279 261 280
91 81 86 79 82 84 88 90
276 271 274 270 281 263 277
80 91 81 86 79 82 84 88 90
153 154
70 181
232 70 181
133 38 39 135 132 134 205 199 209 214 216 201 213 220 204 217 223 198 224 195 203 218 206 194 196 212 197 210 215 221 202 222 208 211 219
99 100
250 255
248 250 255
251 248 250 255
239 240
26 133 38 39 135 132 134 205 199 209 214 216 201 213 220 204 217 223 198 224 195 203 218 206 194 196 212 197 210 215 221 202 222 208 211 219
241 239 240
155 153 154
245 246
176 99 100
249 254
251 248 250 255 249 254
163 164
8 288
253 251 248 250 255 249 254
19 20
169 184
230 231
68 114
53 230 231
116 53 230 231
229 116 53 230 231
62 63
4 229 116 53 230 231
52 55
243 4 229 116 53 230 231
242 243 4 229 116 53 230 231
52 55 242 243 4 229 116 53 230 231
165 62 63
283 289
54 52 55 242 243 4 229 116 53 230 231
265 279 261 280 276 271 274 270 281 263 277
13 14
10 13 14
16 10 13 14
32 33
165 62 63 54 52 55 242 243 4 229 116 53 230 231
296 16 10 13 14
182 163 164
46 173
65 46 173
108 182 163 164
58 283 289
155 153 154 108 182 163 164
51 110
27 129
115 165 62 63 54 52 55 242 243 4 229 116 53 230 231
12 296 16 10 13 14
17 12 296 16 10 13 14
19 20 65 46 173
58 283 289 51 110
27 129 115 165 62 63 54 52 55 242 243 4 229 116 53 230 231
149 169 184
148 68 114
285 155 153 154 108 182 163 164
17 12 296 16 10 13 14 27 129 115 165 62 63 54 52 55 242 243 4 229 116 53 230 231
56 106
80 91 81 86 79 82 84 88 90 232 70 181
93 102
92 8 288
290 93 102
176 99 100 80 91 81 86 79 82 84 88 90 232 70 181
136 104 105
78 117
128 56 106
35 67
170 290 93 102
75 78 117
40 17 12 296 16 10 13 14 27 129 115 165 62 63 54 52 55 242 243 4 229 116 53 230 231
61 26 133 38 39 135 132 134 205 199 209 214 216 201 213 220 204 217 223 198 224 195 203 218 206 194 196 212 197 210 215 221 202 222 208 211 219
241 239 240 170 290 93 102
176 99 100 80 91 81 86 79 82 84 88 90 232 70 181 128 56 106
136 104 105 61 26 133 38 39 135 132 134 205 199 209 214 216 201 213 220 204 217 223 198 224 195 203 218 206 194 196 212 197 210 215 221 202 222 208 211 219
179 238
137 292
265 279 261 280 276 271 274 270 281 263 277 136 104 105 61 26 133 38 39 135 132 134 205 199 209 214 216 201 213 220 204 217 223 198 224 195 203 218 206 194 196 212 197 210 215 221 202 222 208 211 219
35 67 176 99 100 80 91 81 86 79 82 84 88 90 232 70 181 128 56 106
265 279 261 280 276 271 274 270 281 263 277 136 104 105 61 26 133 38 39 135 132 134 205 199 209 214 216 201 213 220 204 217 223 198 224 195 203 218 206 194 196 212 197 210 215 221 202 222 208 211 219 35 67 176 99 100 80 91 81 86 79 82 84 88 90 232 70 181 128 56 106
159 285 155 153 154 108 182 163 164
126 75 78 117
179 238 265 279 261 280 276 271 274 270 281 263 277 136 104 105 61 26 133 38 39 135 132 134 205 199 209 214 216 201 213 220 204 217 223 198 224 195 203 218 206 194 196 212 197 210 215 221 202 222 208 211 219 35 67 176 99 100 80 91 81 86 79 82 84 88 90 232 70 181 128 56 106
77 139
3 179 238 265 279 261 280 276 271 274 270 281 263 277 136 104 105 61 26 133 38 39 135 132 134 205 199 209 214 216 201 213 220 204 217 223 198 224 195 203 218 206 194 196 212 197 210 215 221 202 222 208 211 219 35 67 176 99 100 80 91 81 86 79 82 84 88 90 232 70 181 128 56 106
225 3 179 238 265 279 261 280 276 271 274 270 281 263 277 136 104 105 61 26 133 38 39 135 132 134 205 199 209 214 216 201 213 220 204 217 223 198 224 195 203 218 206 194 196 212 197 210 215 221 202 222 208 211 219 35 67 176 99 100 80 91 81 86 79 82 84 88 90 232 70 181 128 56 106
137 292 225 3 179 238 265 279 261 280 276 271 274 270 281 263 277 136 104 105 61 26 133 38 39 135 132 134 205 199 209 214 216 201 213 220 204 217 223 198 224 195 203 218 206 194 196 212 197 210 215 221 202 222 208 211 219 35 67 176 99 100 80 91 81 86 79 82 84 88 90 232 70 181 128 56 106
241 239 240 170 290 93 102 126 75 78 117
159 285 155 153 154 108 182 163 164 241 239 240 170 290 93 102 126 75 78 117
19 20 65 46 173 137 292 225 3 179 238 265 279 261 280 276 271 274 270 281 263 277 136 104 105 61 26 133 38 39 135 132 134 205 199 209 214 216 201 213 220 204 217 223 198 224 195 203 218 206 194 196 212 197 210 215 221 202 222 208 211 219 35 67 176 99 100 80 91 81 86 79 82 84 88 90 232 70 181 128 56 106
58 283 289 51 110 19 20 65 46 173 137 292 225 3 179 238 265 279 261 280 276 271 274 270 281 263 277 136 104 105 61 26 133 38 39 135 132 134 205 199 209 214 216 201 213 220 204 217 223 198 224 195 203 218 206 194 196 212 197 210 215 221 202 222 208 211 219 35 67 176 99 100 80 91 81 86 79 82 84 88 90 232 70 181 128 56 106
245 246 58 283 289 51 110 19 20 65 46 173 137 292 225 3 179 238 265 279 261 280 276 271 274 270 281 263 277 136 104 105 61 26 133 38 39 135 132 134 205 199 209 214 216 201 213 220 204 217 223 198 224 195 203 218 206 194 196 212 197 210 215 221 202 222 208 211 219 35 67 176 99 100 80 91 81 86 79 82 84 88 90 232 70 181 128 56 106
183 159 285 155 153 154 108 182 163 164 241 239 240 170 290 93 102 126 75 78 117
228 245 246 58 283 289 51 110 19 20 65 46 173 137 292 225 3 179 238 265 279 261 280 276 271 274 270 281 263 277 136 104 105 61 26 133 38 39 135 132 134 205 199 209 214 216 201 213 220 204 217 223 198 224 195 203 218 206 194 196 212 197 210 215 221 202 222 208 211 219 35 67 176 99 100 80 91 81 86 79 82 84 88 90 232 70 181 128 56 106
142 77 139
66 228 245 246 58 283 289 51 110 19 20 65 46 173 137 292 225 3 179 238 265 279 261 280 276 271 274 270 281 263 277 136 104 105 61 26 133 38 39 135 132 134 205 199 209 214 216 201 213 220 204 217 223 198 224 195 203 218 206 194 196 212 197 210 215 221 202 222 208 211 219 35 67 176 99 100 80 91 81 86 79 82 84 88 90 232 70 181 128 56 106
183 159 285 155 153 154 108 182 163 164 241 239 240 170 290 93 102 126 75 78 117 66 228 245 246 58 283 289 51 110 19 20 65 46 173 137 292 225 3 179 238 265 279 261 280 276 271 274 270 281 263 277 136 104 105 61 26 133 38 39 135 132 134 205 199 209 214 216 201 213 220 204 217 223 198 224 195 203 218 206 194 196 212 197 210 215 221 202 222 208 211 219 35 67 176 99 100 80 91 81 86 79 82 84 88 90 232 70 181 128 56 106
247 149 169 184
244 183 159 285 155 153 154 108 182 163 164 241 239 240 170 290 93 102 126 75 78 117 66 228 245 246 58 283 289 51 110 19 20 65 46 173 137 292 225 3 179 238 265 279 261 280 276 271 274 270 281 263 277 136 104 105 61 26 133 38 39 135 132 134 205 199 209 214 216 201 213 220 204 217 223 198 224 195 203 218 206 194 196 212 197 210 215 221 202 222 208 211 219 35 67 176 99 100 80 91 81 86 79 82 84 88 90 232 70 181 128 56 106
148 68 114 247 149 169 184
258 259
299 244 183 159 285 155 153 154 108 182 163 164 241 239 240 170 290 93 102 126 75 78 117 66 228 245 246 58 283 289 51 110 19 20 65 46 173 137 292 225 3 179 238 265 279 261 280 276 271 274 270 281 263 277 136 104 105 61 26 133 38 39 135 132 134 205 199 209 214 216 201 213 220 204 217 223 198 224 195 203 218 206 194 196 212 197 210 215 221 202 222 208 211 219 35 67 176 99 100 80 91 81 86 79 82 84 88 90 232 70 181 128 56 106
253 251 248 250 255 249 254 299 244 183 159 285 155 153 154 108 182 163 164 241 239 240 170 290 93 102 126 75 78 117 66 228 245 246 58 283 289 51 110 19 20 65 46 173 137 292 225 3 179 238 265 279 261 280 276 271 274 270 281 263 277 136 104 105 61 26 133 38 39 135 132 134 205 199 209 214 216 201 213 220 204 217 223 198 224 195 203 218 206 194 196 212 197 210 215 221 202 222 208 211 219 35 67 176 99 100 80 91 81 86 79 82 84 88 90 232 70 181 128 56 106
144 253 251 248 250 255 249 254 299 244 183 159 285 155 153 154 108 182 163 164 241 239 240 170 290 93 102 126 75 78 117 66 228 245 246 58 283 289 51 110 19 20 65 46 173 137 292 225 3 179 238 265 279 261 280 276 271 274 270 281 263 277 136 104 105 61 26 133 38 39 135 132 134 205 199 209 214 216 201 213 220 204 217 223 198 224 195 203 218 206 194 196 212 197 210 215 221 202 222 208 211 219 35 67 176 99 100 80 91 81 86 79 82 84 88 90 232 70 181 128 56 106
190 191
40 17 12 296 16 10 13 14 27 129 115 165 62 63 54 52 55 242 243 4 229 116 53 230 231 144 253 251 248 250 255 249 254 299 244 183 159 285 155 153 154 108 182 163 164 241 239 240 170 290 93 102 126 75 78 117 66 228 245 246 58 283 289 51 110 19 20 65 46 173 137 292 225 3 179 238 265 279 261 280 276 271 274 270 281 263 277 136 104 105 61 26 133 38 39 135 132 134 205 199 209 214 216 201 213 220 204 217 223 198 224 195 203 218 206 194 196 212 197 210 215 221 202 222 208 211 219 35 67 176 99 100 80 91 81 86 79 82 84 88 90 232 70 181 128 56 106
21 112
143 142 77 139
32 33 21 112
123 40 17 12 296 16 10 13 14 27 129 115 165 62 63 54 52 55 242 243 4 229 116 53 230 231 144 253 251 248 250 255 249 254 299 244 183 159 285 155 153 154 108 182 163 164 241 239 240 170 290 93 102 126 75 78 117 66 228 245 246 58 283 289 51 110 19 20 65 46 173 137 292 225 3 179 238 265 279 261 280 276 271 274 270 281 263 277 136 104 105 61 26 133 38 39 135 132 134 205 199 209 214 216 201 213 220 204 217 223 198 224 195 203 218 206 194 196 212 197 210 215 221 202 222 208 211 219 35 67 176 99 100 80 91 81 86 79 82 84 88 90 232 70 181 128 56 106
2 107
92 8 288 123 40 17 12 296 16 10 13 14 27 129 115 165 62 63 54 52 55 242 243 4 229 116 53 230 231 144 253 251 248 250 255 249 254 299 244 183 159 285 155 153 154 108 182 163 164 241 239 240 170 290 93 102 126 75 78 117 66 228 245 246 58 283 289 51 110 19 20 65 46 173 137 292 225 3 179 238 265 279 261 280 276 271 274 270 281 263 277 136 104 105 61 26 133 38 39 135 132 134 205 199 209 214 216 201 213 220 204 217 223 198 224 195 203 218 206 194 196 212 197 210 215 221 202 222 208 211 219 35 67 176 99 100 80 91 81 86 79 82 84 88 90 232 70 181 128 56 106
190 191 92 8 288 123 40 17 12 296 16 10 13 14 27 129 115 165 62 63 54 52 55 242 243 4 229 116 53 230 231 144 253 251 248 250 255 249 254 299 244 183 159 285 155 153 154 108 182 163 164 241 239 240 170 290 93 102 126 75 78 117 66 228 245 246 58 283 289 51 110 19 20 65 46 173 137 292 225 3 179 238 265 279 261 280 276 271 274 270 281 263 277 136 104 105 61 26 133 38 39 135 132 134 205 199 209 214 216 201 213 220 204 217 223 198 224 195 203 218 206 194 196 212 197 210 215 221 202 222 208 211 219 35 67 176 99 100 80 91 81 86 79 82 84 88 90 232 70 181 128 56 106
186 190 191 92 8 288 123 40 17 12 296 16 10 13 14 27 129 115 165 62 63 54 52 55 242 243 4 229 116 53 230 231 144 253 251 248 250 255 249 254 299 244 183 159 285 155 153 154 108 182 163 164 241 239 240 170 290 93 102 126 75 78 117 66 228 245 246 58 283 289 51 110 19 20 65 46 173 137 292 225 3 179 238 265 279 261 280 276 271 274 270 281 263 277 136 104 105 61 26 133 38 39 135 132 134 205 199 209 214 216 201 213 220 204 217 223 198 224 195 203 218 206 194 196 212 197 210 215 221 202 222 208 211 219 35 67 176 99 100 80 91 81 86 79 82 84 88 90 232 70 181 128 56 106
148 68 114 247 149 169 184 186 190 191 92 8 288 123 40 17 12 296 16 10 13 14 27 129 115 165 62 63 54 52 55 242 243 4 229 116 53 230 231 144 253 251 248 250 255 249 254 299 244 183 159 285 155 153 154 108 182 163 164 241 239 240 170 290 93 102 126 75 78 117 66 228 245 246 58 283 289 51 110 19 20 65 46 173 137 292 225 3 179 238 265 279 261 280 276 271 274 270 281 263 277 136 104 105 61 26 133 38 39 135 132 134 205 199 209 214 216 201 213 220 204 217 223 198 224 195 203 218 206 194 196 212 197 210 215 221 202 222 208 211 219 35 67 176 99 100 80 91 81 86 79 82 84 88 90 232 70 181 128 56 106
145 148 68 114 247 149 169 184 186 190 191 92 8 288 123 40 17 12 296 16 10 13 14 27 129 115 165 62 63 54 52 55 242 243 4 229 116 53 230 231 144 253 251 248 250 255 249 254 299 244 183 159 285 155 153 154 108 182 163 164 241 239 240 170 290 93 102 126 75 78 117 66 228 245 246 58 283 289 51 110 19 20 65 46 173 137 292 225 3 179 238 265 279 261 280 276 271 274 270 281 263 277 136 104 105 61 26 133 38 39 135 132 134 205 199 209 214 216 201 213 220 204 217 223 198 224 195 203 218 206 194 196 212 197 210 215 221 202 222 208 211 219 35 67 176 99 100 80 91 81 86 79 82 84 88 90 232 70 181 128 56 106
143 142 77 139 32 33 21 112
30 37
57 145 148 68 114 247 149 169 184 186 190 191 92 8 288 123 40 17 12 296 16 10 13 14 27 129 115 165 62 63 54 52 55 242 243 4 229 116 53 230 231 144 253 251 248 250 255 249 254 299 244 183 159 285 155 153 154 108 182 163 164 241 239 240 170 290 93 102 126 75 78 117 66 228 245 246 58 283 289 51 110 19 20 65 46 173 137 292 225 3 179 238 265 279 261 280 276 271 274 270 281 263 277 136 104 105 61 26 133 38 39 135 132 134 205 199 209 214 216 201 213 220 204 217 223 198 224 195 203 218 206 194 196 212 197 210 215 221 202 222 208 211 219 35 67 176 99 100 80 91 81 86 79 82 84 88 90 232 70 181 128 56 106
298 30 37
2 107 143 142 77 139 32 33 21 112
57 145 148 68 114 247 149 169 184 186 190 191 92 8 288 123 40 17 12 296 16 10 13 14 27 129 115 165 62 63 54 52 55 242 243 4 229 116 53 230 231 144 253 251 248 250 255 249 254 299 244 183 159 285 155 153 154 108 182 163 164 241 239 240 170 290 93 102 126 75 78 117 66 228 245 246 58 283 289 51 110 19 20 65 46 173 137 292 225 3 179 238 265 279 261 280 276 271 274 270 281 263 277 136 104 105 61 26 133 38 39 135 132 134 205 199 209 214 216 201 213 220 204 217 223 198 224 195 203 218 206 194 196 212 197 210 215 221 202 222 208 211 219 35 67 176 99 100 80 91 81 86 79 82 84 88 90 232 70 181 128 56 106 298 30 37
258 259 57 145 148 68 114 247 149 169 184 186 190 191 92 8 288 123 40 17 12 296 16 10 13 14 27 129 115 165 62 63 54 52 55 242 243 4 229 116 53 230 231 144 253 251 248 250 255 249 254 299 244 183 159 285 155 153 154 108 182 163 164 241 239 240 170 290 93 102 126 75 78 117 66 228 245 246 58 283 289 51 110 19 20 65 46 173 137 292 225 3 179 238 265 279 261 280 276 271 274 270 281 263 277 136 104 105 61 26 133 38 39 135 132 134 205 199 209 214 216 201 213 220 204 217 223 198 224 195 203 218 206 194 196 212 197 210 215 221 202 222 208 211 219 35 67 176 99 100 80 91 81 86 79 82 84 88 90 232 70 181 128 56 106 298 30 37
2 107 143 142 77 139 32 33 21 112 258 259 57 145 148 68 114 247 149 169 184 186 190 191 92 8 288 123 40 17 12 296 16 10 13 14 27 129 115 165 62 63 54 52 55 242 243 4 229 116 53 230 231 144 253 251 248 250 255 249 254 299 244 183 159 285 155 153 154 108 182 163 164 241 239 240 170 290 93 102 126 75 78 117 66 228 245 246 58 283 289 51 110 19 20 65 46 173 137 292 225 3 179 238 265 279 261 280 276 271 274 270 281 263 277 136 104 105 61 26 133 38 39 135 132 134 205 199 209 214 216 201 213 220 204 217 223 198 224 195 203 218 206 194 196 212 197 210 215 221 202 222 208 211 219 35 67 176 99 100 80 91 81 86 79 82 84 88 90 232 70 181 128 56 106 298 30 37